# LEMMA INDEX
# Hebrew word : English word : filename


א
אָדֹם : red : 2adom  
אוּרִים וְתֻמִּים : Urim Thummim : 2urim_wthummim
אַרְגְּוָן : bright purple : 2argwan
אַרְגָּמָן : bright purple : 2argaman
ארר : to curse : 2-r-r
 

ב
בֶּקַע : beka : beqa3
ברך : to bless : b-r-k_2
בָּרָד : hail : barad
בְּרָכָה : blessing: brakah 

ג
גְּאוּלִים : redemption : g2ulim
גאל : to redeem : g-2-l
גְּאֻלָּה : redemption, right of : g2ullah


ד
דֶּרֶךְ : road, way : derek

ה
הֲדֹם : footstool : hadom

ו

ז

ח
חֹזֶה : (court) diviner : chozeh
חַשְׁמַן : amethyst(?) : chashman

ט
טוה : to spin, twist : t-w-h

י
יְשׁוּעָה : protection : yshu3ah
ישׁע : to save, help : y-sh-3
יֵשַׁע : safety : yesha3

ך

כ
כְּלִי : vessel : kli
כִּסֵּא : throne : kisse2
כַּרְמִיל : bright, rich red : karmil

ל
לָבָן : white : laban

מ
מָאוֹר : light : ma2or
מְגִלָּה : scroll : mgillah
מוֹשָׁעָה : deliverance : mosha3ah
מַחֲרָשָׁה/מַחֲרֶשֶׁת : plough : machareshah
מַפְרֶקֶת : neck : mapreqeth


נ
נָבִיא/נְבִיאָה : prophet(ess) : nabi2

ס

ע
עֶזְרָה : help : 3ezrah
עֲטָרָה : wreath, crown : 3atarah

פ
פדה : to liberate : p-d-h
פְּדוּיִם : redemption price : pduyim
פְּדוּת : redemption-action : pduth
פִּדְיוֹן : ransom : pidyon
פֶּלֶךְ : spindle : pelek
פרק : to pull off : p-r-q
פָּרָק : piece of meat : paraq
פֶּרֶק : plunder : pereq


צ
צלה : to roast : ts-l-h

ק
קבב : to curse : q-b-b


ר
רֹאֶה : seer : ro2eh

ש
שָׁנִי : bright red dye : shani_1
שׁוֹעַ : great man : shoa3
שׁוּעַ : cry for help : shua3

ת
תְּבוּנָה : understanding : thbunah
תְּכֵלֶת : bluish purple : thkeleth
תִּפְלָה : senselessness : thiplah
תְּשׁוּעָה : deliverance, state of : thshu3ah


